/*
 * 32x24 map data
 */
const unsigned short PA_Map[768] = {
0x0000, 0x0000, 0x0000, 0x0000, 0x0000, 0x0000, 0x0000, 0x0000, 
0x0000, 0x0000, 0x0000, 0x0000, 0x0000, 0x0000, 0x0000, 0x0000, 
0x0000, 0x0000, 0x0000, 0x0000, 0x0000, 0x0000, 0x0000, 0x0000, 
0x0000, 0x0000, 0x0000, 0x0000, 0x0000, 0x0000, 0x0000, 0x0000, 
0x0000, 0x0000, 0x0000, 0x0000, 0x0000, 0x0000, 0x0000, 0x0000, 
0x0000, 0x0000, 0x0000, 0x0000, 0x0000, 0x0000, 0x0000, 0x0000, 
0x0000, 0x0000, 0x0000, 0x0000, 0x0000, 0x0000, 0x0000, 0x0000, 
0x0000, 0x0000, 0x0000, 0x0000, 0x0000, 0x0000, 0x0000, 0x0000, 
0x0000, 0x0000, 0x0000, 0x0000, 0x0000, 0x0000, 0x0000, 0x0000, 
0x0000, 0x0000, 0x0000, 0x0000, 0x0000, 0x0000, 0x0000, 0x0000, 
0x0000, 0x0000, 0x0000, 0x0000, 0x0000, 0x0000, 0x0000, 0x0000, 
0x0000, 0x0000, 0x0000, 0x0000, 0x0000, 0x0000, 0x0000, 0x0000, 
0x0000, 0x0000, 0x0000, 0x0000, 0x0000, 0x0000, 0x0000, 0x0000, 
0x0000, 0x0000, 0x0000, 0x0000, 0x0000, 0x0000, 0x0000, 0x0000, 
0x0000, 0x0000, 0x0000, 0x0001, 0x0002, 0x0003, 0x0004, 0x0005, 
0x0006, 0x0007, 0x0000, 0x0000, 0x0000, 0x0000, 0x0000, 0x0000, 
0x0000, 0x0000, 0x0000, 0x0000, 0x0000, 0x0000, 0x0000, 0x0000, 
0x0000, 0x0000, 0x0000, 0x0000, 0x0000, 0x0000, 0x0000, 0x0008, 
0x0009, 0x000a, 0x000b, 0x000c, 0x000d, 0x000e, 0x000f, 0x000f, 
0x0010, 0x0011, 0x0012, 0x0000, 0x0000, 0x0000, 0x0000, 0x0000, 
0x0000, 0x0000, 0x0000, 0x0000, 0x0000, 0x0000, 0x0000, 0x0000, 
0x0000, 0x0000, 0x0000, 0x0013, 0x0014, 0x0015, 0x0016, 0x0017, 
0x0018, 0x0019, 0x001a, 0x001b, 0x001c, 0x001d, 0x000f, 0x001e, 
0x001f, 0x0020, 0x0021, 0x0000, 0x0000, 0x0000, 0x0000, 0x0000, 
0x0000, 0x0000, 0x0000, 0x0000, 0x0000, 0x0022, 0x0023, 0x0000, 
0x0024, 0x0025, 0x0026, 0x0027, 0x0028, 0x0029, 0x002a, 0x002b, 
0x002c, 0x002d, 0x002e, 0x002f, 0x0030, 0x0031, 0x0032, 0x0033, 
0x0034, 0x0035, 0x0036, 0x0037, 0x0000, 0x0000, 0x0000, 0x0000, 
0x0000, 0x0000, 0x0000, 0x0038, 0x0039, 0x003a, 0x003b, 0x003c, 
0x003d, 0x003e, 0x003f, 0x0040, 0x0041, 0x0042, 0x0043, 0x0044, 
0x0045, 0x0046, 0x0047, 0x0000, 0x0000, 0x0048, 0x0049, 0x004a, 
0x004b, 0x004c, 0x004d, 0x004e, 0x004f, 0x0000, 0x0000, 0x0000, 
0x0000, 0x0000, 0x0000, 0x0050, 0x0051, 0x0052, 0x0053, 0x0054, 
0x0055, 0x0056, 0x0057, 0x0058, 0x0059, 0x005a, 0x0000, 0x0000, 
0x0000, 0x0000, 0x0000, 0x0000, 0x0000, 0x0000, 0x005b, 0x005c, 
0x005d, 0x005e, 0x005f, 0x0060, 0x0061, 0x0000, 0x0000, 0x0000, 
0x0000, 0x0000, 0x0062, 0x0063, 0x0064, 0x0065, 0x0066, 0x0067, 
0x0068, 0x0069, 0x006a, 0x006b, 0x0000, 0x0000, 0x0000, 0x0000, 
0x0000, 0x0000, 0x0000, 0x0000, 0x0000, 0x0000, 0x006c, 0x006d, 
0x006e, 0x006f, 0x0070, 0x0071, 0x0000, 0x0000, 0x0000, 0x0000, 
0x0000, 0x0000, 0x0072, 0x0073, 0x0074, 0x0075, 0x0076, 0x0077, 
0x0000, 0x0000, 0x0000, 0x0000, 0x0000, 0x0000, 0x0000, 0x0000, 
0x0000, 0x0000, 0x0000, 0x0000, 0x0000, 0x0000, 0x0000, 0x0000, 
0x0078, 0x0079, 0x007a, 0x007b, 0x0000, 0x0000, 0x0000, 0x0000, 
0x0000, 0x0000, 0x0000, 0x007c, 0x007d, 0x007e, 0x007f, 0x0000, 
0x0000, 0x0080, 0x0081, 0x0000, 0x0000, 0x0080, 0x0082, 0x0000, 
0x0000, 0x0083, 0x0084, 0x0000, 0x0000, 0x0085, 0x0082, 0x0000, 
0x0086, 0x0085, 0x0082, 0x0000, 0x0000, 0x0000, 0x0000, 0x0000, 
0x0000, 0x0000, 0x0000, 0x0000, 0x0087, 0x0088, 0x0089, 0x008a, 
0x0087, 0x008b, 0x008c, 0x008d, 0x008e, 0x008f, 0x0090, 0x0091, 
0x0092, 0x0093, 0x0094, 0x0095, 0x0096, 0x0097, 0x0098, 0x0099, 
0x009a, 0x009b, 0x009c, 0x009d, 0x0000, 0x0000, 0x0000, 0x0000, 
0x0000, 0x0000, 0x0000, 0x0000, 0x009e, 0x009f, 0x00a0, 0x00a1, 
0x00a2, 0x00a3, 0x00a4, 0x00a5, 0x00a6, 0x00a7, 0x00a8, 0x00a9, 
0x00aa, 0x00ab, 0x00ac, 0x00ad, 0x00ae, 0x00af, 0x00b0, 0x00b1, 
0x00b2, 0x00b3, 0x00b4, 0x00b5, 0x00b6, 0x0000, 0x0000, 0x0000, 
0x0000, 0x0000, 0x0000, 0x0000, 0x00b7, 0x00b8, 0x00b9, 0x00ba, 
0x00bb, 0x00bc, 0x00bd, 0x00be, 0x00bf, 0x00c0, 0x00c1, 0x00c2, 
0x00c3, 0x00c4, 0x00c5, 0x00c6, 0x00c7, 0x00c8, 0x00c9, 0x00ca, 
0x00cb, 0x00cc, 0x00cd, 0x00ce, 0x00cf, 0x0000, 0x0000, 0x0000, 
0x0000, 0x0000, 0x0000, 0x0000, 0x00d0, 0x00d1, 0x00d2, 0x00d3, 
0x00d4, 0x00d5, 0x00d6, 0x00d7, 0x087e, 0x00d8, 0x00d9, 0x00da, 
0x00db, 0x00dc, 0x00dd, 0x00de, 0x00df, 0x00e0, 0x00e1, 0x00e2, 
0x00e3, 0x00e4, 0x00e5, 0x00e6, 0x0000, 0x0000, 0x0000, 0x0000, 
0x0000, 0x0000, 0x0000, 0x0000, 0x00e7, 0x00e8, 0x00e9, 0x00ea, 
0x00eb, 0x00ec, 0x00ed, 0x00ee, 0x00ee, 0x00ee, 0x00ee, 0x00ee, 
0x00ef, 0x00f0, 0x00f1, 0x00f2, 0x00f3, 0x00f4, 0x00f5, 0x00f6, 
0x00f7, 0x00f8, 0x00f9, 0x00fa, 0x0000, 0x0000, 0x0000, 0x0000, 
0x0000, 0x0000, 0x0000, 0x0000, 0x00fb, 0x00fc, 0x00fd, 0x00fe, 
0x00ff, 0x0100, 0x0101, 0x00ee, 0x00ee, 0x00ee, 0x00ee, 0x0102, 
0x0103, 0x0104, 0x0105, 0x0106, 0x0107, 0x0108, 0x0109, 0x010a, 
0x010b, 0x010c, 0x010d, 0x010e, 0x0000, 0x0000, 0x0000, 0x0000, 
0x0000, 0x0000, 0x0000, 0x0000, 0x0000, 0x0000, 0x0000, 0x0000, 
0x0000, 0x0000, 0x0000, 0x0000, 0x0000, 0x0000, 0x0000, 0x0000, 
0x0000, 0x0000, 0x0000, 0x0000, 0x0000, 0x0000, 0x0000, 0x0000, 
0x0000, 0x0000, 0x0000, 0x0000, 0x0000, 0x0000, 0x0000, 0x0000, 
0x0000, 0x0000, 0x0000, 0x0000, 0x010f, 0x0110, 0x0111, 0x0112, 
0x0113, 0x0114, 0x0510, 0x0115, 0x0116, 0x0114, 0x0117, 0x0118, 
0x0119, 0x0110, 0x011a, 0x011b, 0x011c, 0x051c, 0x011d, 0x011e, 
0x051d, 0x011d, 0x050f, 0x011f, 0x0514, 0x0000, 0x0000, 0x0000, 
0x0000, 0x0000, 0x0000, 0x0000, 0x0120, 0x0121, 0x0122, 0x0123, 
0x0124, 0x0125, 0x0126, 0x0127, 0x0128, 0x0129, 0x012a, 0x012b, 
0x012c, 0x0526, 0x012d, 0x012e, 0x012f, 0x0130, 0x0131, 0x0132, 
0x0133, 0x0134, 0x0135, 0x0136, 0x0137, 0x0000, 0x0000, 0x0000, 
0x0000, 0x0000, 0x0000, 0x0000, 0x0000, 0x0000, 0x0000, 0x0000, 
0x0000, 0x0138, 0x0000, 0x0000, 0x0000, 0x0139, 0x0000, 0x0000, 
0x0000, 0x0000, 0x0000, 0x0000, 0x0000, 0x0000, 0x0000, 0x0000, 
0x0000, 0x0000, 0x0000, 0x013a, 0x013b, 0x0000, 0x0000, 0x0000, 
0x0000, 0x0000, 0x0000, 0x0000, 0x0000, 0x0000, 0x0000, 0x0000, 
0x0000, 0x0000, 0x0000, 0x0000, 0x0000, 0x0000, 0x0000, 0x0000, 
0x0000, 0x0000, 0x0000, 0x0000, 0x0000, 0x0000, 0x0000, 0x0000, 
0x0000, 0x0000, 0x0000, 0x0000, 0x0000, 0x0000, 0x0000, 0x0000, 
0x0000, 0x0000, 0x0000, 0x0000, 0x0000, 0x0000, 0x0000, 0x0000, 
0x0000, 0x0000, 0x0000, 0x0000, 0x0000, 0x0000, 0x0000, 0x0000, 
0x0000, 0x0000, 0x0000, 0x0000, 0x0000, 0x0000, 0x0000, 0x0000, 
0x0000, 0x0000, 0x0000, 0x0000, 0x0000, 0x0000, 0x0000, 0x0000
};

